

# d
####                                                                                 ###   m   ##
###########                                                                        ##############
###########                                                                     #################
###########  ##                                                                ##################
###########  ####                                                             ###################
###########  #######                                                         ####################
###########  #######                                                 ********####################
###########  #######                 ******                     p    ############################
###########  ###########   **********######       m        ##       #############################
###########  ###########   ##################################      ##############################
###########  ###########   ######################################################################
###########  ###########   ######################################################################

                                                                 ###




                           #
                           #     #
                           #     #      #
                           #     #      #           #
                           #     #      #           #
                           ####################################
